Species	Status
Adusta_pulchella	extant
Afrocypraea_chubbi	extinct
Afrozoila_caputavisensis	extinct
Afrozoila_gendinganensis	extinct
Afrozoila_kendengensis	extinct
Afrozoila_schilderi	extinct
Afrozoila_zietsmani	extinct
Akleistostoma	extinct
Akleistostoma_bairdi	extinct
Akleistostoma_carolinensis	extinct
Akleistostoma_crocodila	extinct
Akleistostoma_diegelae	extinct
Akleistostoma_erici	extinct
Akleistostoma_floridana	extinct
Akleistostoma_hughesi	extinct
Akleistostoma_jenniferae	extinct
Akleistostoma_macbrideae	extinct
Akleistostoma_pilsbryi	extinct
Akleistostoma_rilkoi	extinct
Archicypraea	extinct
Archicypraea_ancillaria	extinct
Archicypraea_bellardiana	extinct
Archicypraea_lioyi	extinct
Archicypraea_prisca	extinct
Archicypraea_superba	extinct
Arestorides_argus	extant
Austrocypraea_amae	extinct
Austrocypraea_contusa	extinct
Austrocypraea_goudeyana	extinct
Austrocypraea_rumballi	extinct
Austrocypraea_towncreekensis	extinct
Barycypraea_bensoni	extinct
Barycypraea_caputviperae	extinct
Barycypraea_humerosa	extinct
Barycypraea_murisimilis	extinct
Barycypraea_orangensis	extinct
Barycypraea_saltoensis	extinct
Barycypraea_singuensis	extinct
Barycypraea_subtetragona	extinct
Barycypraea_suryai	extinct
Bernaya	extinct
Bernaya_(Bernaya)_azevedoi	extinct
Bernaya_(Bernaya)_baluchistanensis	extinct
Bernaya_(Bernaya)_beardi	extinct
Bernaya_(Bernaya)_burlingtonensis	extinct
Bernaya_(Bernaya)_coromandelica	extinct
Bernaya_(Bernaya)_crawfordcatei	extinct
Bernaya_(Bernaya)_depereti	extinct
Bernaya_(Bernaya)_ellipsoides	extinct
Bernaya_(Bernaya)_gemmellaroi	extinct
Bernaya_(Bernaya)_jeanae	extinct
Bernaya_(Bernaya)_obesa	extinct
Bernaya_(Protocypraea)_argonautica	extinct
Bernaya_(Protocypraea)_berryessae	extinct
Bernaya_(Protocypraea)_cunliffei	extinct
Bernaya_(Protocypraea)_globuliformis	extinct
Bernaya_(Protocypraea)_gualalaensis	extinct
Bernaya_(Protocypraea)_kayei	extinct
Bernaya_(Protocypraea)_kohatica	extinct
Bernaya_(Protocypraea)_louellasaulae	extinct
Bernaya_(Protocypraea)_mississippiensis	extinct
Bernaya_(Protocypraea)_popenoei	extinct
Bernaya_(Protocypraea)_rineyi	extinct
Bernaya_(Protocypraea)_sayni	extinct
Bernaya_(Protocypraea)_veraghoorensis	extinct
Bernaya_grovesi	extinct
Bernaya_kaylinae	extinct
Bernaya_quarunensis	extinct
Bistolida	extinct
Bistolida_erythraeensis	extant
Callistocypraea_(Miolyncina)_prunum	extinct
Callistocypraea_(Miolyncina)_soriensis	extinct
Calusacypraea_(Myakkacypraea)_kelleyi	extinct
Calusacypraea_(Myakkacypraea)_myakka	extinct
Calusacypraea_(Myakkacypraea)_schnireli	extinct
Calusacypraea_briani	extinct
Calusacypraea_globulina	extinct
Calusacypraea_sarasotaensis	extinct
Calusacypraea_tequesta	extinct
Chelycypraea_(Miolyncina)_subovum	extinct
Cribrarula_cribraria	extant
Cribrarula_gaskoini	extant
Cypraea	extinct
Cypraea_(Aricia)_beberkiriana	extinct
Cypraea_(Aricia)_simplicissima	extinct
Cypraea_(Cypraea)	extinct
Cypraea_(Cypraeorbis)_heilprinii	extinct
Cypraea_(Erosaria)_caputserpentis	extant
Cypraea_(Erosaria)_guttata	extant
Cypraea_(Erosaria)_helvola	extant
Cypraea_(Erosaria)_malekulensis	extinct
Cypraea_(Erosaria)_sindiensis	extinct
Cypraea_(Erronea)_mbalavuensis	extinct
Cypraea_(Luponia)_subchinensis	extinct
Cypraea_(Luria)_cinerea	extant
Cypraea_(Luria)_isabella_lekalekana	extinct
Cypraea_(Lyncina)_lynx	extant
Cypraea_(Lyncina)_porteri	extant
Cypraea_(Lyncina)_schilderorum	extant
Cypraea_(Lyncina)_vitellus	extant
Cypraea_(Macrocypraea)_spengleri	extant
Cypraea_(Mauritia)_histrio	extant
Cypraea_(Palmadusta)_asellus	extant
Cypraea_(Purpuradusta)_fimbriata	extant
Cypraea_(Staphylaea)_nucleus	extant
Cypraea_(Zoila)_itoigawai	extinct
Cypraea_boucheti	extinct
Cypraea_ohiroi	extinct
Cypraea_pantherina	extant
Cypraea_pediculus	extinct
Cypraea_pennae	extinct
Cypraea_problematica	extinct
Cypraea_sulcosa	extinct
Cypraea_tigris	extinct
Cypraeacites_inflatus	extinct
Cypraeacites_persona	extinct
Cypraeidae	extinct
Cypraeinae	extinct
Cypraeopsis_(Cypraeopsis)_aquensis	extinct
Cypraeopsis_vandervlerki	extinct
Cypraeorbis	extinct
Cypraeorbis_alabamensis	extinct
Cypraeorbis_arlettae	extinct
Cypraeorbis_boggsi	extinct
Cypraeorbis_bulbus	extinct
Cypraeorbis_exsplendens	extinct
Cypraeorbis_gaasensis	extinct
Cypraeorbis_kendrewi	extinct
Cypraeorbis_noveli	extinct
Cypraeorbis_nuculoides	extinct
Cypraeorbis_sphaeroides	extinct
Cypraeorbis_splendens	extinct
Cypraeorbis_vaughani	extinct
Cypraeorbis_ventripotens	extinct
Cypraeorbis_vesicularis	extinct
Cypraeorbis_willcoxi	extinct
Cypraeorbis_willcoxi_ballista	extinct
Cypraeovula	extinct
Cypraeovula_(Cypraeovula)_capensis	extant
Eclogavena_quadrimaculata	extinct
Eopustularia_acyensis	extinct
Eopustularia_balinka	extinct
Eopustularia_bartonensis	extinct
Eopustularia_brackleshamensis	extinct
Eopustularia_gregorioi	extinct
Eopustularia_moloni	extinct
Eotrivia_(Eotrivia)_bouryi	extinct
Eotrivia_baronensis	extinct
Eotrivia_faracii	extinct
Eotrivia_palumbella	extinct
Eotrivia_pedicularis	extinct
Eotrivia_procera	extinct
Eotrivia_recluzi	extinct
Eratotrivia_crenata	extinct
Erosaria	extinct
Erosaria_(Erosaria)_kutaiana	extinct
Erosaria_(Erosaria)_pliostaphylaea	extinct
Erosaria_(Erosaria)_sabahensis	extant
Erosaria_acicularis	extant
Erosaria_aliena	extinct
Erosaria_cernica	extant
Erosaria_citrina	extinct
Erosaria_eburnea	extant
Erosaria_erosa	extant
Erosaria_everwijni	extinct
Erosaria_labrolineata	extant
Erosaria_miliaris	extinct
Erosaria_ocellata	extant
Erosaria_poraria	extant
Erosaria_spurca	extant
Erosaria_turdus	extant
Erronea	extinct
Erronea_(Adusta)_cowiei	extant
Erronea_(Adusta)_ijzermani	extinct
Erronea_(Adusta)_jungens	extinct
Erronea_(Adusta)_onyx	extinct
Erronea_(Adusta)_posewitzi	extant
Erronea_(Adusta)_proxima	extinct
Erronea_(Adusta)_rembangensis	extinct
Erronea_(Adusta)_semicostata	extinct
Erronea_(Adusta)_sondeiana	extinct
Erronea_(Cribraria)	extinct
Erronea_(Cribraria)_cincta	extinct
Erronea_(Gratiadusta)_nasuta	extinct
Erronea_(Melicerona)_felina	extant
Erronea_caurica	extant
Erronea_cylindrica	extinct
Erronea_errones	extant
Erronea_pyriformis	extant
Eucypraea_ahmadi	extinct
Fossacypraea_apiceproducta	extinct
Fossacypraea_eburnina	extinct
Fossacypraea_extusdentata	extinct
Fossacypraea_hieroglyphica	extinct
Gisortia	extinct
Gisortia_(Vicetia)_hantkeni	extinct
Gisortia_(Vicetia)_stefaninii	extinct
Gisortia_brevis	extinct
Gisortia_clarki	extinct
Gisortia_colombiana	extinct
Gisortia_gigantea	extinct
Gisortia_harrisi	extinct
Gisortia_ibrahimi	extinct
Gisortia_mahgoobi	extinct
Gisortia_murchisoni	extinct
Gisortia_tuberculosa	extinct
Ipsa_childreni	extant
Jousseaumea_diluviana	extinct
Jousseaumea_grateloupi	extinct
Jousseaumea_joossi	extinct
Jousseaumea_sublyncoides	extinct
Jousseaumea_taurorotunda	extinct
Loxacypraea_apalachicolae	extinct
Loxacypraea_chilona	extinct
Loxacypraea_colligens	extinct
Loxacypraea_emilyae	extinct
Loxacypraea_genei	extinct
Loxacypraea_orbignyana	extinct
Loxacypraea_plumbea	extinct
Luria	extinct
Luria_(Basilitrona)_jenkinsi	extinct
Luria_(Basilitrona)_patrespatriae	extinct
Luria_(Tessellata)_cahuzaci	extinct
Luria_(Tessellata)_castinea	extinct
Luria_(Tessellata)_chattica	extinct
Luria_(Tessellata)_pelouaensis	extinct
Luria_campbelliana	extinct
Luria_cantaurana	extinct
Luria_dominicensis	extinct
Luria_isabella	extant
Luria_isabellaprimitiva	extinct
Luria_lurida	extant
Luria_mariaelisabethae	extinct
Luria_tessellata	extant
Luria_voleki	extant
Lyncina_(Austrocypraea)_archeri	extinct
Lyncina_(Austrocypraea)_onkastoma	extinct
Lyncina_(Austrocypraea)_scalena	extinct
Lyncina_amygdalina	extinct
Lyncina_camelopardalis	extant
Lyncina_carneola	extant
Lyncina_cingulata	extinct
Lyncina_eristicos	extinct
Lyncina_imperialis	extinct
Lyncina_leviathan	extant
Lyncina_maestratii	extinct
Lyncina_magnifica	extinct
Lyncina_miopropinqua	extinct
Lyncina_peyroti	extinct
Lyncina_praecedens	extinct
Lyncina_tumida	extinct
Macrocypraea	extinct
Macrocypraea_anguillana	extinct
Macrocypraea_cervus	extant
Macrocypraea_joanneae	extinct
Macrocypraea_veintensis	extinct
Macrocypraea_zebra	extant
Mandolina_pergibba	extinct
Mandolina_rhomboidalis	extinct
Mauritia_(Mauritia)_uzestensis	extinct
Mauritia_arabica	extant
Mauritia_eglantina	extant
Mauritia_grayana	extant
Mauritia_maculifera	extant
Mauritia_mauritiana	extant
Mauritia_scurra	extant
Megalocypraea_thomasi	extinct
Miolyncina_cocconii	extinct
Miolyncina_conjungens	extinct
Miolyncina_prevostina	extinct
Monetaria_annulus	extant
Monetaria_moneta	extant
Muracypraea	extinct
Muracypraea_andersoni	extinct
Muracypraea_angustirima	extinct
Muracypraea_caroniensis	extinct
Muracypraea_cayapa	extinct
Muracypraea_donmoorei	extant
Muracypraea_grahami	extinct
Muracypraea_henekeni	extinct
Muracypraea_hyaena	extinct
Muracypraea_isthmica	extinct
Muracypraea_mus	extant
Muracypraea_ormenoi	extinct
Muracypraea_projecta	extinct
Muracypraea_tuberae	extinct
Muracypraea_woodringi	extant
Naria_erosa	extant
Neobernaya_porcellus	extinct
Neobernaya_spadicea	extant
Notadusta	extinct
Notadusta_egregia	extinct
Notadusta_punctata	extant
Notadusta_spolongensis	extinct
Notadusta_trelissickensis	extinct
Notadusta_victoriana	extinct
Notocypraea_darraghi	extinct
Notocypraea_eryma	extinct
Notocypraea_goudeyi	extinct
Notocypraea_jonesiana	extinct
Notoluponia_murraviana	extinct
Notoluponia_pyrulata	extinct
Nucleolaria_bezoyensis	extinct
Nucleolaria_cowlitziana	extinct
Nucleolaria_granulata	extant
Ovatipsa_chinensis	extant
Ovulum	extinct
Palaeocypraea	extinct
Palaeocypraea_(Palaeocypraea)_anomala	extinct
Palaeocypraea_(Palaeocypraea)_caffrarica	extinct
Palaeocypraea_(Palaeocypraea)_corsicanana	extinct
Palaeocypraea_(Palaeocypraea)_deserti	extinct
Palaeocypraea_(Palaeocypraea)_desertorum	extinct
Palaeocypraea_(Palaeocypraea)_drumensis	extinct
Palaeocypraea_(Palaeocypraea)_faxensis	extinct
Palaeocypraea_(Palaeocypraea)_korycanensis	extinct
Palaeocypraea_(Palaeocypraea)_libyca	extinct
Palaeocypraea_(Palaeocypraea)_limburgensis	extinct
Palaeocypraea_(Palaeocypraea)_maestrichtensis	extinct
Palaeocypraea_(Palaeocypraea)_paronai	extinct
Palaeocypraea_(Palaeocypraea)_primigenia	extinct
Palaeocypraea_(Palaeocypraea)_tithonica	extinct
Palaeocypraea_(Palaeocypraea)_titonica	extinct
Palaeocypraea_(Palaeocypraea)_vayssierei	extinct
Palaeocypraea_(Pustulariopsis)_globulina	extinct
Palaeocypraea_(Pustulariopsis)_pustulifera	extinct
Palaeocypraea_eripnides	extinct
Palaeocypraea_fontana	extinct
Palaeocypraea_grooti	extinct
Palaeocypraea_nuciformis	extinct
Palaeocypraea_spirata	extinct
Palaeocypraea_squyeri	extinct
Palaeocypraea_suciensis	extinct
Palaeocypraea_suecica	extinct
Palaeocypraea_wilfredi	extinct
Palmadusta_(Palmadusta)_modjokertensis	extinct
Palmadusta_clandestina	extant
Pedicularia	extinct
Pedicularia_(Pedicularia)	extinct
Pedicularia_deshayesiana	extinct
Pedicularia_navakaensis	extinct
Pedicularia_pacifica	extant
Plaziatia_amandula	extinct
Plaziatia_estotiensis	extinct
Plaziatia_parasigmapertura	extinct
Plaziatia_subglobosa	extinct
Praerosaria_amoenacea	extinct
Praerosaria_biacuta	extinct
Praerosaria_charlenae	extinct
Praerosaria_espibosensis	extinct
Praerosaria_exflaveola	extinct
Praerosaria_herosae	extinct
Praerosaria_paulonaria	extinct
Praerosaria_perlacea	extinct
Praerosaria_pseudorugosa	extinct
Praerosaria_tabulata	extinct
Proadusta	extinct
Proadusta_bitruncata	extinct
Proadusta_camiadorum	extinct
Proadusta_distorta	extinct
Proadusta_elliptica	extinct
Proadusta_gemmosa	extinct
Proadusta_inaequilabiata	extinct
Proadusta_parvissima	extinct
Proadusta_parvitala	extinct
Proadusta_rostralina	extinct
Proadusta_truncata	extinct
Propustularia	extinct
Propustularia_bartschi	extinct
Propustularia_caribaea	extinct
Propustularia_gurabonis	extinct
Propustularia_kemperae	extinct
Propustularia_longidentata	extinct
Propustularia_paraguanensis	extinct
Propustularia_parisimina	extinct
Protocypraea	extinct
Protocypraea_riachuelana	extinct
Protocypraea_simiensis	extinct
Protoponda_vinassai	extinct
Prozonarina_barcamorpha	extinct
Prozonarina_brocchii	extinct
Prozonarina_expansa	extinct
Prozonarina_fabagina	extinct
Prozonarina_haueriana	extinct
Prozonarina_maxima	extinct
Prozonarina_regalis	extinct
Pseudadusta_hertweckorum	extinct
Pseudadusta_kalafuti	extinct
Pseudadusta_ketteri	extinct
Pseudadusta_lindae	extinct
Pseudadusta_marilynae	extinct
Pseudozonaria_annettae	extant
Pseudozonaria_arabicula	extant
Pseudozonaria_cathyae	extinct
Pseudozonaria_falconensis	extinct
Pseudozonaria_fehsei	extinct
Pseudozonaria_frassinettii	extinct
Pseudozonaria_nigropunctata	extant
Pseudozonaria_portelli	extant
Pseudozonaria_praeaequinoctialis	extinct
Pseudozonaria_primarobertsi	extinct
Pseudozonaria_raymondrobertsi	extinct
Pseudozonaria_telembiensis	extinct
Purpuradusta_gracilis	extant
Purpuradusta_microdon	extant
Pustularia_(Pustularia)_americana	extinct
Pustularia_cicercula	extant
Pustularia_globulus	extant
Pustularia_kamai	extinct
Pustularia_lodanensis	extinct
Pustularia_margarita	extinct
Ransonia_coseli	extinct
Ransonia_faviai	extinct
Ransonia_ferruginosa	extinct
Ransonia_gofasi	extinct
Ransonia_senuti	extinct
Ransonia_tarbelliana	extinct
Schilderia_amygdalum	extinct
Schilderia_andegavensis	extinct
Schilderia_brebioni	extinct
Schilderia_columbaria	extinct
Schilderia_decorticata	extinct
Schilderia_fasciolaria	extinct
Schilderia_flavicula	extinct
Schilderia_garonettii	extinct
Schilderia_incognita	extinct
Schilderia_lauriatae	extinct
Schilderia_longiscata	extinct
Schilderia_plioamygdalum	extinct
Schilderia_pseudamygdalum	extinct
Schilderia_semidenticulata	extinct
Schilderia_subannularia	extinct
Schilderia_taurovalis	extinct
Schilderia_utricolata	extinct
Schilderia_veronicata	extinct
Semicypraea_koninckii	extinct
Siphocypraea	extinct
Siphocypraea_(Okeechobea)_brantleyi	extinct
Siphocypraea_(Pahayokea)_alligator	extinct
Siphocypraea_(Pahayokea)_aspenae	extinct
Siphocypraea_(Pahayokea)_basingerensis	extinct
Siphocypraea_(Pahayokea)_erici	extinct
Siphocypraea_(Pahayokea)_gabrielleae	extinct
Siphocypraea_(Pahayokea)_josiai	extinct
Siphocypraea_(Pahayokea)_kissimmeensis	extinct
Siphocypraea_(Pahayokea)_mansfieldi	extinct
Siphocypraea_(Pahayokea)_parodizi	extinct
Siphocypraea_(Pahayokea)_penningtonorum	extinct
Siphocypraea_(Pahayokea)_rucksorum	extinct
Siphocypraea_almirantensis	extinct
Siphocypraea_amandusi	extinct
Siphocypraea_cannoni	extinct
Siphocypraea_dimasi	extinct
Siphocypraea_duerri	extinct
Siphocypraea_griffini	extinct
Siphocypraea_grovesi	extinct
Siphocypraea_macrovoluta	extinct
Siphocypraea_merriami	extinct
Siphocypraea_metae	extinct
Siphocypraea_mulepenensis	extinct
Siphocypraea_pennai	extinct
Siphocypraea_philemoni	extinct
Siphocypraea_posei	extinct
Siphocypraea_problematica	extinct
Siphocypraea_transitoria	extinct
Siphocypraea_trippeana	extinct
Staphylaea_(Nuclearia)_soloensis	extinct
Staphylaea_(Staphylaea)_staphylaea	extant
Staphylaea_limacina	extinct
Stolida_(Cribraria)_quilonensis	extinct
Subepona_antiqua	extinct
Subepona_goedertorum	extinct
Subepona_herrerensis	extinct
Subepona_leahae	extinct
Subepona_promeces	extinct
Talostolida_teres	extant
Talparia_(Arestorides)_nahaensis	extinct
Talparia_(Talparia)_mariaelisabethae	extinct
Talparia_talpa	extant
Trona_apenninensis	extinct
Trona_carcarensis	extinct
Trona_ingrami	extinct
Trona_leporina	extinct
Trona_lyncoides	extinct
Trona_stercoraria	extant
Trona_subporcellus	extinct
Trona_trinitatensis	extinct
Umbilia_(Palliocypraea)_gastroplax	extinct
Umbilia_(Umbilia)_angustior	extinct
Umbilia_(Umbilia)_eximia	extinct
Umbilia_(Umbilia)_hesitata	extant
Umbilia_(Umbilia)_leptorhyncha	extinct
Umbilia_(Umbilia)_platyrhyncha	extinct
Umbilia_(Umbilia)_prosila	extinct
Umbilia_(Umbilia)_siphonata	extinct
Umbilia_caepa	extinct
Umbilia_furneauxensis	extinct
Vicetia_bizzottoi	extinct
Vicetia_sowerbyi	extinct
Vicetia_vredenburgi	extinct
Zoila	extinct
Zoila_campestris	extinct
Zoila_chathamensis	extinct
Zoila_didymorhyncha	extinct
Zoila_dolichorhyncha	extinct
Zoila_fodinata	extinct
Zoila_gigas	extinct
Zoila_glomerabilis	extinct
Zoila_mulderi	extinct
Zoila_platypyga	extinct
Zoila_viathomsoni	extinct
Zonaria	extinct
Zonaria_(Pseudozonaria)_cathyae	extinct
Zonaria_(Zonaria)_pittorum	extinct
Zonaria_(Zonaria)_pyrum	extant
Zonaria_dertamygdaloides	extinct
Zonaria_dujardini	extinct
Zonaria_globosa	extinct
Zonaria_heilprinii	extinct
Zonaria_pingata	extinct
Zonaria_porcellus	extinct
Zonaria_praelatior	extinct
Zonaria_pseudotumulus	extinct
Zonaria_shirleyae	extinct
Zonaria_simonnei	extinct
Zonaria_spurcoides	extinct
Zonaria_theresae	extinct
Zonaria_travancorica	extinct
Zonaria_tumulus	extinct
Zonaria_zonata	extant
Zonarina_abbessensis	extinct
Zonarina_annularia	extinct
Zonarina_aturensis	extinct
Zonarina_brogniarti	extinct
Zonarina_exglobosa	extinct
Zonarina_haueri	extinct
Zonarina_liviae	extinct
Zonarina_maynotensis	extinct
Zonarina_pinguis	extinct
Zonarina_provincialis	extinct
Zonarina_subelongata	extinct
